1111111111111
100C0000000C1
1110011110001
1P0011E000001
1111111111111